F F F B B B B X X B B X X X X X X X X X 
F F F F B B X X X X X X X X X X X X X X 
F F B B B B X B B B X X X X X X X X X X 
F F F B B B B X X X X X X X X X X X X X 
F F F B B B B X X B X X X X X X X X X X 
F F F B B B B B X X B X X X X X X X X X 
F F F B B X X B B B X X X X X X X X X X 
F F F F B B B X B X B X X X X X X X X X 
F F F F F B B B B B B X X X X X X X X X 
F F F F F F B B B X B X X X X X X X X X 
F F F F F B B B B B X X X X X X X X X X 
F F F F F B F B B B B B X X X X X X X X 
F F F F F B B B B X X X X X X X X X X X 
F F F F F F F B B X X B X X X B X X X X 
F F F F F F B B X X X B B B X X B X X B 
F F F F F F F F B B B B B X B X X X B X 
F F F F F F F B B B B B B X B B X X B B 
F F F F F F B F B B B F B B B B X B B B 
F F F F F F F F F F F F F B B B B B B B 
F F F F F F F F F F F F B F F X B B B F 
