F F F F F F B B X B B B X B X X X X X X 
F F F F F F B B B B B X B X X X X X X X 
F F F F B F B B B B B X B X X X X X X X 
F F F F F B B B X X B X X X X X X X X X 
F F F F B B B B B B X X X X X X X X X X 
F F F F F B B B X B B B X X X X X X X X 
F F F F F B B B B B B X X X X X X X X X 
F F F F F F F B B B B B X B X X X X X X 
F F F F F F F B B B B X B X X X X X X X 
F F F F F F F B B X B B X X X X X X X X 
F F F F F F F B B B X X B B X X X X X X 
F F F F F F F B B B B B B X X X X X X X 
F F F F F F F F B B B B X B B X X X X X 
F F F F F F F F B B B B B B X B B X X X 
F F F F F F F F B B B B B B X X B B X B 
F F F F F F F F B F B B B B B X X B B X 
F F F F F F F F F F B B B B B B B X B B 
F F F F F F F F F F F F F F B B B B B B 
F F F F F F F F F F F F F F F B B B B F 
F F F F F F F F F F F F F F F B F B F F 
